111111111111111111111111111          111111111111111111111111111
100000000000000000000000001          100000000000000000000000001
100000000000000000000000001          100000000000000000000000001
100000000000000000000000001          100000000000000000000000001
100000000000000000000000001          100000000000000000000000001
100000000000000000000000001          100000000000000000000000001
100000000000000000000000001          100000000000000000000000001
100000000000000000000000001          100000000000000000000000001
100000000000000000000000001          100000000000000000000000001
111111111111000111111111111          111111111111000111111111111
           10001                                10001           
           10001                                10001           
           10001                                10001           
           10001                                10001           
           10001                                10001           
111111111111000111111111111          111111111111000111111111111
100000000000000000000000001          100000000000000000000000001
100000000000000000000000001          100000000000000000000000001
100000000000000000000000001          100000000000000000000000001
1000000000000000000000000011111111111100000000000000000000000001
1000000000000000000000000000000000000000000000000000000000000001
1000000000000000000000000000000000000000000000000000000000000001
1000000000000000000000000000000000000000000000000000000000000001
1000000000000000000000000011111111111100000000000000000000000001
100000000000000000000000001          100000000000000000000000001
100000000000000000000000001          100000000000000000000000001
100000000000000000000000001          100000000000000000000000001
111111111111000111111111111          111111111111000111111111111
           10001                                10001           
           10001                                10001           
           10001                                10001           
           10001                                10001           
           10001                                10001           
111111111111000111111111111          111111111111000111111111111
100000000000000000000000001          100000000000000000000000001
100000000000000000000000001          100000000000000000000000001
100000000000000000000000001          100000000000000000000000001
100000000000000000000000001          100000000000000000000000001
100000000000000000000000001          100000000000000000000000001
100000000000000000000000001          100000000000000000000000001
100000000000000000000000001          100000000000000000000000001
100000000000000000000000001          100000000000000000000000001
111111111111000111111111111          111111111111000111111111111
           10001                                10001
           10001                                10001
           10001                                10001
           10001                                10001
           10001                                10001
           100011111111111111111111111111111111110001
           100000000000000000000000000000000000000001
           100000000000000000000000000000000000000001
           111111111111111111111101111111111111111111
                                101
                                101
           111111111111111111111101111111111111111111
           100000000000000000000000000000000000000001
           101111111111111111111111111111111111111101
           100000000000000000000000000000000000000001
           101111111111111111111111111111111111111111
           100000000000000000000000000000000000000001
           111111111111111111111111111111111111111101
           100000000000000000000000000000000000000001
           111111111111111111111111111111111111111111