NO ../textures/north_wall.xpm
SO ../textures/south_wall.xpm
WE ../textures/west_wall.xpm
EA ../textures/east_wall.xpm

F 220,100,0
C 225,30,0

1111111111111111111111111111          111111111111111111111111111
1000000000000000000000000001          100000000000000000000000001
1000000000000000000000000001          100000000000000000000000001
1000000000000000000000000001          100000000000000000000000001
10000000000000S0000000000001          100000000000000000000000001
1000000000000000000000000001          100000000000000000000000001
1000000000000000000000000001          100000000000000000000000001
1000000000000000000000000001          100000000000000000000000001
1000000000000000000000000001          100000000000000000000000001
1111111111111000111111111111          111111111111000111111111111
            10001                                10001           
            10001                                10001           
            10001                                10001           
            10001                                10001           
            10001                                10001           
1111111111111000111111111111          111111111111000111111111111
1000000000000000000000000001          100000000000000000000000001
1000000000000000000000000001          100000000000000000000000001
1000000000000000000000000001          100000000000000000000000001
10000000000000000000000000011111111111100000000000000000000000001
10000000000000000000000000000000000000000000000000000000000000001
10000000000000000000000000000000000000000000000000000000000000001
10000000000000000000000000000000000000000000000000000000000000001
10000000000000000000000000011111111111100000000000000000000000001
1000000000000000000000000001          100000000000000000000000001
1000000000000000000000000001          100000000000000000000000001
1000000000000000000000000001          100000000000000000000000001
1111111111111000111111111111          111111111111000111111111111
            10001                                10001           
            10001                                10001           
            10001                                10001           
            10001                                10001           
            10001                                10001           
1111111111111000111111111111          111111111111000111111111111
1000000000000000000000000001          100000000000000000000000001
1000000000000000000000000001          100000000000000000000000001
1000000000000000000000000001          100000000000000000000000001
1000000000000000000000000001          100000000000000000000000001
1000000000000000000000000001          100000000000000000000000001
1000000000000000000000000001          100000000000000000000000001
1000000000000000000000000001          100000000000000000000000001
1000000000000000000000000001          100000000000000000000000001
1111111111111000111111111111          111111111111000111111111111
            10001                                10001
            10001                                10001
            10001                                10001
            10001                                10001
            10001                                10001
            100011111111111111111111111111111111110001
            100000000000000000000000000000000000000001
            100000000000000000000000000000000000000001
            111111111111111111111011111111111111111111
                                101
                                101
                                1011111111111111111111
                                1000000000000000000001
                                1111111111111111111101
                                                   101
            111111111111111111111111111111111111111101
            100000000000000000000000000000000000000001
            101111111111111111111111111111111111111111
            101
            101111111111111111111111111111111111111111
            100000000000000000000000000000000000000001
            111111111111111111111111111111111111111101
                                                   101
            111111111111111111111111111111111111111101
            100000000000000000000000000000000000000001
            111111111111111111111111111111111111111111