111111111111111111111111111
100000000000000000000000001
100000000000000000000000001
100000000000000000000000001
100000000000001000000000001
100000000000001000000000001
100000000000001000000000001
100000000000000000000000001
100000000000000000000000101
111111111111111111111111111