NO ./textures/birds/1.xpm
SO ./textures/birds/2.xpm
WE ./textures/birds/3.xpm
EA ./textures/birds/4.xpm

C 2,130,255
F 180,64,100

111111111111111111111111111111111111111111111111
10000000000000000000000000E00000000001
11111111111111111111111111111111111111
