NO ./textures/birds/1.xpm
SO ./textures/birds/2.xpm
WE ./textures/birds/3.xpm
EA ./textures/birds/4.xpm

F 180,64,100
C 2,130,255

1111111111111111111111111
1000000000000000000000001
10110S0011101110000000001
100000000000001011000000111111111111111
111111111000001001110000000000000000001
    10000000000000011111011111111111101
11111011111111011100000000001       101
11100011111111011100000110001111111110111111111111111111111
11000000110101011100000110000000000000000000000000000000001
10000000000000001100000010001111111110111111101111111011111
10000000000000001101010010001       101    10011  11001
110000011101010111110111100011111111101    101111110011
11110111 1110101 1011110100000000000001    10000000011
11111111 1111111 1111111111111111111111    1111111111