NO ./textures/birds/1.xpm
SO ./textures/birds/2.xpm
WE ./textures/birds/3.xpm
EA ./textures/birds/4.xpm

F 180,64,100
C 2,130,255

1111111111111111111111111E