NO ./textures/birds/1.xpm
SO ./textures/birds/2.xpm
WE ./textures/birds/3.xpm
EA ./textures/birds/4.xpm

C +2,130,255
F 180,64,+100

11111111111
1111111111
10E00001
11011111
11111111