NO ./textures/dogs/1.xpm
SO ./textures/dogs/2.xpm
WE ./textures/dogs/3.xpm
EA ./textures/dogs/4.xpm
DR ./textures/funny/1.xpm

C 2,130,255
F 220,64,65

1111111111111111111111111
10000S0000000000000000001
10110000111D1110000000001
100D0000D000001011000000111111111111111
111111111000001001110000000000000000001
    10000000000000011111D11111111111101
11111D11111111D11100000000001       101
11100011111111011100000110001111111110111111111111111111111
1100000011010101110000011000000000000D000000000000000000001
10000000000000001100000010001111111110111111101111111011111
10000000000000001101010010001       101    10011  11001
110000011101010111110111100011111111101    101111110011
11110111 1110101 1011110100000000000001    10000000011
11111111 1111111 1111111111111111111111    1111111111