NO ./textures/doodles/1.xpm
SO ./textures/doodles/2.xpm
WE ./textures/doodles/3.xpm
EA ./textures/doodles/4.xpm

F 180,64,100
C 2,130,255

1111111111111111111111111
1000010000000000000000001
1011000011101110000000001
100000000000001011000000111111111111111
111111111000001001110000000000000000001
    10000000000000011111011111111111101
11111011111111111100000000001       101
11100011111111011100000110001111111110111111111111111111111
1100000011E101011100000110000000000000000000000000000000001
10000000000000001100000010001111111110111111101111111011111
100000111100000001101010010001       101    10011  11001
110010011101010111110111100011111111101    101111110011
11110111 1110101 1011110100000000000001    10000000011
11111111 1111111 1111111111111111111111    1111111111