NO ../textures/north_wall.xpm
SO ../textures/south_wall.xpm
WE ../textures/west_wall.xpm
EA ../textures/east_wall.xpm

F 220,100,0
C 225,30,0

1111111111111111011111111
10000E0000110000000000001
1011000001110000000000001
100100000000000000000000111111111111111
111111111011000001110000000000000000001
100000000011000001110111111111111111101
11110111111111011100000000001       101
11110111111111011101010010001       101
11000000110101011100000010001       101
10000000000000001100000010001       101
10000000000000001101010010001       101
110000011101010111110111100011111111101
11110111 1110101 1011110100000000000001
11111111 1111111 1111111111111111111111