NO ./path_to_the_north_texture
SO ./path_to_the_south_texture
WE ./path_to_the_west_texture
EA ./path_to_the_east_texture
F 220,100,0
C 225,30,0

  111111111111111111111111111111111111111111111111111111111111111111111111111111111111111111111111
  100000001100000000000000000000000000000000000000000000000000000000000000000000000000000000000001
11110000011100000000000011111111111111111111111111111111111111111111000000000000000000000000000001
10010000000000000000000011111111111111111111111111111111111111111111000000000000000000000000000001
11111111101100000111000000000000000000000000000000000000000000000000000000000000000000000000000001
10000000001100000111000000001111011110111101111011110111101111011111000000000000000000000000000001
11110111111111011100000000001  101  101  101  101  101  101  101   1000000000000000000000000000001
11110111111111011100000000001  101  101  101  101  101  101  101   1000000000000000000000000000001
11000000110001011100000000001  101  101  101  101  101  101  101   1000000000000000000000000000001
1000S000000000000000000000001  101  101  101  101  101  101  101   1000000000000000000000000000001
10000000000000000000000000001111011110111101111011110111101111011111000000000000000000000000000001
  100011100000111100000000000000000000000000000000000000000000000000000000000000000000000000000001
   10111 1100001 100000000001111111111111111111111111111111111111111111111111111111111111111111111
    1111 1111111 11111111111