111111111111111
100000000000N01
101111111110101
100000000000101
111111011111101
100000010000001
101110010111101
100010010100001
101010111111101
100010000000001
111111111111111