1111111111111111111111111111111111111111111111111111111111111111111111111111111111111111111111111111
1000000000000000000000000000000000000000000000000000111111111111111111111111111111111111111111111100
10W11111111111111111111111111111111111111111111111111111000000000000000000000000000000000000000000101
10100000000000000000000000000000000000000000000000000000011111111111111111111111111111111111111000001
10101111111111111111111111111111111111111111111111111111100000000000000000000000000000000000011110101
10101000000000000000000000000000000000000000000000000000111111111111111111111111111111111000000000101
10101111111111111111111111111111111111111111111111111111000000000000000000000000000000000011111110101
10000000000000000000000000000000000000000000000000000000111111111111111111111111111111111111000000101
11111111111111111111111111111111111111111111111111111110000000000000000000000000000000000000001110101
10000000000000000000000000000000000000000000000000000001111111111111111111111111111111111111111000101
10111111111111111111111111111111111111111111111111111110000000000000000000000000000000000000011110101
10100000000000000000000000000000000000000000000000000000011111111111111111111111111111111111000000101
10101111111111111111111111111111111111111111111111111111100000000000000000000000000000000000011110101
10000000000000000000000000000000000000000000000000000000111111111111111111111111111111111111000000101
11111111111111111111111111111111111111111111111111111110000000000000000000000000000000000000011110101
10000000000000000000000000000000000000000000000000000001111111111111111111111111111111111111110000101
10111111111111111111111111111111111111111111111111111110000000000000000000000000000000000000000101
10100000000000000000000000000000000000000000000000000001111111111111111111111111111111111111111000101
10101111111111111111111111111111111111111111111111111110000000000000000000000000000000000000001110101
10000000000000000000000000000000000000000000000000000000111111111111111111111111111111111111000000101
11111111111111111111111111111111111111111111111111111110000000000000000000000000000000000000011110101
10000000000000000000000000000000000000000000000000000001111111111111111111111111111111111111110000101
10111111111111111111111111111111111111111111111111111110000000000000000000000000000000000000000101
10100000000000000000000000000000000000000000000000000001111111111111111111111111111111111111000101
10101111111111111111111111111111111111111111111111111110000000000000000000000000000000000000010101
10000000000000000000000000000000000000000000000000000001111111111111111111111111111111111111110000101
11111111111111111111111111111111111111111111111111111110000000000000000000000000000000000000001110101
10000000000000000000000000000000000000000000000000000001111111111111111111111111111111111111110000101
10111111111111111111111111111111111111111111111111111110000000000000000000000000000000000000010101
10100000000000000000000000000000000000000000000000000001111111111111111111111111111111111111000101
10101111111111111111111111111111111111111111111111111110000000000000000000000000000000000000010101
10000000000000000000000000000000000000000000000000000001111111111111111111111111111111111111110000101
11111111111111111111111111111111111111111111111111111110000000000000000000000000000000000000001110101
10000000000000000000000000000000000000000000000000000001111111111111111111111111111111111111110000101
10111111111111111111111111111111111111111111111111111110000000000000000000000000000000000000010101
10100000000000000000000000000000000000000000000000000001111111111111111111111111111111111111000101
10101111111111111111111111111111111111111111111111111110000000000000000000000000000000000000010101
10000000000000000000000000000000000000000000000000000001111111111111111111111111111111111111110000101
11111111111111111111111111111111111111111111111111111110000000000000000000000000000000000000001110101
