11111111111111111111111111111111111111111111111111111111111111111111111111111111111111111111111111
10000000001100000000000000000000000000000000000000000000000000000000000000000000000000000000000001
10110000011100000000000011111111111111111111111111111111111111111111000000000000000000000000000001
10010000000000000000000011111111111111111111111111111111111111111111000000000000000000000000000001
11111111101100000111000000000000000000000000000000000000000000000000000000000000000000000000000001
10000000001100000111000000001111011110111101111011110111101111011111000000000000000000000000000001
11110111111111011100000000001  101  101  101  101  101  101  101   1000000000000000000000000000001
11110111111111011100000000001  101  101  101  101  101  101  101   1000000000000000000000000000001
11000000110001011100000000001  101  101  101  101  101  101  101   1000000000000000000000000000001
1000N000000000000000000000001  101  101  101  101  101  101  101   1000000000000000000000000000001
10000000000000000000000000001111011110111101111011110111101111011111000000000000000000000000000001
 1000001110000011110000000000000000000000000000000000000000000000000000000000000000000000000000001
  110111 1100001 100000000001111111111111111111111111111111111111111111111111111111111111111111111
   11111 1111111 111111111111