1111111111111111111111111
1000000000110000000000001
1011000001110000000000001
100100000000000000000000111111111111111
111111111011000001110000000000000000001
100000000011000001110111111111111111101
11110111111111011100000010001       101
11110111111111011101010010001       101
11000000110101011100000010001       101
10000000000000001100000010001       101
100000000000000011010100000011111111101
01000001110101011111011110N000000000001
00110111 1110101 1011110100011111111111
00011111 1111111 111111111111