NO ./textures/birds/1.xpm
SO ./textures/birds/2.xpm
WE ./textures/birds/3.xpm
EA ./textures/birds/4.xpm
DR ./textures/cats/1.xpm

F 180,64,100
C 2,130,255

11111111111111111111111111111111
11111 111111111111111111E011111   
    111111000000000000000001
11111111111111111111111111111111
