NO ./textures/birds/1.xpm
SO ./textures/birds/2.xpm
WE ./textures/birds/3.xpm
EA ./textures/birds/4.xpm
DR ./textures/cats/1.xpm

F 180,64,100
C 2,130,255

   111111111111111111111111111111111
111111111111111111111111111111111111
100000000000000000000000E00000000001
101111111111111111111111111111111111
1011111111111111111111111111111111111
101
1011111
10000001
1111111