NO ./textures/dogs/1.xpm
SO ./textures/dogs/2.xpm
WE ./textures/dogs/3.xpm
EA ./textures/dogs/4.xpm
DR ./textures/funny/1.xpm

C 2,130,255
F 220,64,65

1111111111111111111111111
1000000000000000000000001
10110000111D1110000000001
100D0000D000001011000000111111111111111
111111111000001001110000000000000000001
    10000000000000011111D11111111111101
11111D11111111D11100000000001       101
1110001111111101110000011000111111111D111111111111111111111
110000001101010111000001100000000000D0D00000000000000000001
1000000000000000D0000000D000111111111D1111111D1111111D11111
10000000000000001101010010001       101    10011  11001
1100000111010101111101111E0011111111101    101111110011
11110111 1110101 10111101000D0000000001    10000000011
11111111 1111111 1111111111111111111111    1111111111